111111111111111-
144444444444111-
111444111114111-
111444411114111-
111414441114111-
111411444414111-
111411144444111-
111411114444111-
111444444444441-
111111111111111







