111111111111111-
124444444444111-
111444111114111-
111414141114111-
111444144114111-
111411444414111-
111411144444111-
111411114444111-
111444444444421-
111111111111111







