111111111111111-
144444444444111-
111441111114111-
111414411114111-
111411441114111-
111411141114111-
111411114414111-
111411111444111-
111444444444441-
111111111111111