111111111111111-
144444444444111-
111444111114111-
111114441114111-
111111444111111-
111411144114111-
111411114414111-
111411111444111-
111444444444441-
111111111111111