111111111111111-
144444441111111-
144111444411111-
144111114441111-
144411111444111-
114441111144111-
111444111444111-
111144444444111-
111111144444441-
111111111111111