111111111111111-
124444111111111-
114444411111111-
111144444111111-
111111444411111-
111111144441111-
111111114444111-
111111111444411-
111111111144421-
111111111111111