111111111111111-
124444444444111-
111414141414111-
111414141414111-
111414141414111-
111414441414111-
111414441414111-
111414441414111-
111444444444421-
111111111111111