111111111111111-
124414441444111-
111414141414111-
111414141414111-
111414141414111-
111414441414111-
111414441414111-
111414441414111-
111444144414421-
111111111111111