111111111111111-
124444444444111-
111444144444111-
111444144444111-
111444144444111-
111444444444111-
111444444444111-
111444444444111-
111444444444421-
111111111111111







