111111111111111111-
244144414441111111-
114141414141111111-
114141414141111111-
114141414141111111-
114141414141111111-
114141414141111111-
114141414141111111-
114441444144211111-
111111111111111111